BBBBBBBBBBBBBBBBBBBBBBBBBB
B                        B
B                        B
B                        B
B                        B
B                        B
B 1                      B
BAAAAAAAAAAAAAAAAAAAAAAAAB
