BBBBBBBBBBBBBBBBBBBBBBBBBB
B                        B
B                        B
B   A   A                B
B                 AAAA   B
B   AAAAA   AAA          B
B 1                      B
BAAAAAAAAAAAAAAAAAAAAAAAAB
