AAAAAAAAAAAAAAAAAAAAAA
A                    A
A                    A
A    AA        AA    A
AA  AAAA      AAAA  AA
A                    A
A         AA         A
A                    A
A   AAAA      AAAA   A
A        AAAA        A
AA1                2AA
AAA                AAA
A                    A
A   AAAA      AAAA   A
A                    A
A         AA         A
A                    A
A4   AAA      AAA   3A
AA                  AA
AA       A  A       AA
AAAAAAAAAAAAAAAAAAAAAA
