AAAAAAAAA
A       A
AAA     A
A       A
A A 1   A
A       A
AAA     A
A       A
BBBBBBBBB
