AAAAAAAAA
A2      A
AAA     A
A 3     A
A A     A
A1      A
AAA     A
A       A
BBBBBBBBB
